[{
		"level": "1",
		"author": "by 月银秋(QQ2859040107)",
		"map": [
			[2, 2, 2, 2, 2],
			[2, 5, 3, 4, 2],
			[2, 1, 2, 2, 2],
			[2, 2, 2, 0, 0]
		]
	},
	{
		"level": "2",
		"author": "by 月银秋(QQ2859040107)",
		"map": [
			[2, 2, 2, 2, 2, 2],
			[2, 5, 3, 5, 4, 2],
			[2, 1, 3, 5, 5, 2],
			[2, 2, 5, 4, 2, 2],
			[0, 2, 2, 2, 2, 0]
		]
	},
	{
		"level": "3",
		"author": "by 月银秋(QQ2859040107)",
		"map": [
			[2, 2, 2, 2, 2],
			[2, 5, 5, 4, 2],
			[2, 1, 3, 5, 2],
			[2, 5, 5, 2, 2]
		]
	},
	{
		"level": "4",
		"author": "by Rcmcpe(QQ1580893976)",
		"map": [
			[0, 0, 2, 2, 2, 2, 0, 0, 0, 0],
			[2, 2, 2, 5, 5, 2, 2, 2, 2, 2],
			[2, 5, 5, 5, 5, 5, 5, 3, 5, 2],
			[2, 5, 2, 5, 5, 5, 2, 3, 5, 2],
			[2, 5, 5, 4, 5, 4, 2, 1, 5, 2],
			[2, 2, 2, 2, 2, 2, 2, 2, 2, 2]
		]
	},
	{
		"level": "5",
		"author": "by Rcmcpe(QQ1580893976)",
		"map": [
			[0, 2, 2, 2, 2, 2, 2, 2],
			[0, 2, 5, 5, 5, 5, 5, 2],
			[0, 2, 5, 4, 3, 4, 5, 2],
			[2, 2, 5, 3, 1, 3, 5, 2],
			[2, 5, 5, 4, 3, 4, 5, 2],
			[2, 5, 5, 5, 5, 5, 5, 2],
			[2, 2, 2, 2, 2, 2, 2, 2]
		]

	},
	{
		"level": "6",
		"author": "by 数码宝贝51(QQ1911761593)",
		"map": [
			[2, 2, 2, 2, 2, 2, 2, 2, 2, 2, 2, 2, 2],
			[2, 5, 5, 5, 2, 4, 5, 5, 5, 2, 5, 5, 2],
			[2, 5, 5, 3, 2, 5, 5, 2, 5, 2, 3, 5, 2],
			[2, 5, 5, 4, 2, 3, 2, 2, 5, 5, 5, 5, 2],
			[2, 2, 3, 2, 2, 5, 5, 2, 2, 2, 2, 3, 2],
			[2, 4, 5, 4, 2, 4, 5, 3, 5, 5, 2, 5, 2],
			[2, 4, 3, 5, 2, 2, 2, 2, 3, 5, 2, 5, 2],
			[2, 4, 5, 4, 4, 5, 5, 5, 5, 5, 2, 5, 2],
			[2, 2, 5, 2, 2, 2, 2, 2, 2, 2, 2, 5, 2],
			[2, 5, 5, 5, 5, 3, 5, 5, 5, 5, 5, 4, 2],
			[2, 5, 3, 5, 3, 2, 5, 2, 2, 3, 2, 4, 2],
			[2, 5, 5, 5, 5, 2, 1, 2, 5, 4, 2, 5, 2],
			[2, 2, 2, 2, 2, 2, 2, 2, 2, 2, 2, 2, 2]
		]
	},
	{
		"level": "7",
		"author": "by 月银秋(QQ2859040107)",
		"map": [
			[2, 2, 2, 2, 2, 2, 2, 2, 2, 2, 2, 2, 2],
			[2, 1, 5, 5, 2, 5, 5, 5, 5, 5, 5, 5, 2],
			[2, 2, 2, 5, 2, 5, 2, 2, 2, 2, 2, 5, 2],
			[2, 5, 5, 5, 2, 5, 5, 5, 2, 5, 5, 5, 2],
			[2, 5, 2, 5, 2, 2, 2, 5, 2, 5, 2, 5, 2],
			[2, 5, 2, 5, 5, 5, 2, 5, 2, 5, 2, 5, 2],
			[2, 5, 2, 2, 2, 2, 2, 5, 2, 5, 2, 2, 2],
			[2, 5, 5, 5, 2, 5, 5, 5, 2, 5, 5, 5, 2],
			[2, 5, 2, 5, 2, 5, 2, 2, 2, 2, 2, 5, 2],
			[2, 5, 2, 5, 5, 5, 5, 5, 5, 5, 2, 5, 2],
			[2, 5, 2, 2, 2, 2, 2, 2, 2, 2, 2, 5, 2],
			[2, 5, 5, 5, 2, 5, 5, 5, 5, 5, 5, 5, 2],
			[2, 2, 2, 2, 2, 5, 2, 2, 2, 2, 2, 5, 2],
			[2, 5, 5, 5, 5, 5, 2, 5, 5, 5, 5, 5, 2],
			[2, 5, 2, 2, 2, 2, 2, 5, 2, 2, 2, 2, 2],
			[2, 5, 2, 5, 5, 5, 5, 5, 2, 5, 5, 5, 2],
			[2, 5, 2, 2, 2, 2, 2, 2, 2, 5, 2, 5, 2],
			[2, 5, 5, 5, 5, 5, 5, 5, 2, 5, 2, 5, 2],
			[2, 5, 2, 2, 2, 2, 2, 5, 2, 5, 2, 3, 2],
			[2, 5, 5, 5, 5, 5, 2, 5, 5, 5, 2, 4, 2],
			[2, 2, 2, 2, 2, 2, 2, 2, 2, 2, 2, 2, 2]
		]
	}
]
